1111111
1000001
1000101
1200131
1111111