1111111111111111111
1200100010001000001
1000100000100010001
1000100111111110011
1000100100000000001
1000000101111111111
1000000100100000001
1000000110101111001
1000000000000000031
1111111111111111111