1111111131111131111111111
0000000000000000000000001
1111111011100000000000003
1000000001100000011111111
1000100000111111111111111
1000000010110000011111111
1110011111111111111111111
1000000001000000000000001
1000000001000000000000001
1000001000000010100000001
1000001000101001000000011
1000001000100011100000001
1000001000100001100000021
1111111111111111111111111