1111111
1000001
1000001
1200101
1111131