11111101
10001001
10101001
10101001
12100001
11111111