11111111
10000003
11110111
10000001
10101001
12000001
11111111