1111111
1000001
1111011
1000211
1010001
1000101
1111111