11111111111111
30000000000001
11001010111011
10001010100011
10101010111001
10111010000001
11110001111101
10001101000001
10111101111001
10100000100011
10011020010001
10111000010001
10010000010001
11111111111111