11111111111011
00111111111101
10111111111111
10111111111111
10000000000001
10000000000001
10000000000021
11111111111111