1111101
0000000
1111011
1000211
1010001
1000101
1111111